2,2,2,2,2,2,2,2,2,2,2,2,2,2,2,2,2,2,2,2
2,1,1,1,1,1,1,1,1,1,1,1,1,1,1,1,1,1,1,2
2,1,1,1,1,1,1,1,6,1,1,1,1,1,1,1,1,1,1,2
2,2,2,2,5,2,2,2,2,1,1,1,1,1,1,1,1,1,1,2
2,1,1,1,5,1,1,1,1,1,1,1,1,1,1,1,1,1,3,2
2,1,1,1,5,1,1,2,5,1,1,2,2,2,2,2,2,5,2,2
2,1,1,1,5,1,1,2,5,1,1,1,1,1,1,1,1,5,1,2
2,3,1,1,5,1,1,2,5,1,1,1,1,1,1,1,1,5,1,2
2,2,5,2,2,1,1,2,2,2,2,2,2,5,2,2,2,2,2,2
2,1,5,1,1,1,1,1,1,1,1,1,1,5,1,1,1,1,1,2
2,1,5,1,1,1,1,1,1,1,1,1,1,5,1,1,1,1,1,2
2,2,2,2,2,2,5,2,2,2,2,2,2,5,1,1,1,1,1,2
2,1,1,1,1,1,5,1,1,1,1,1,1,5,1,1,1,1,1,2
2,1,1,1,1,1,5,1,1,1,1,1,1,5,1,1,1,1,1,2
2,1,1,5,2,2,2,1,1,1,1,1,1,2,2,2,2,2,5,2
2,7,1,5,1,3,1,1,1,1,4,1,1,1,1,1,1,1,5,2
2,2,2,2,2,2,2,2,2,2,2,2,2,2,2,2,2,2,2,2