1,1,1,1,1,1,1,1,1,1,1,1,1,1,1,1,1,1,1,1
1,0,0,0,0,0,0,0,0,0,0,0,0,0,0,0,0,0,0,1
1,0,0,0,0,0,0,0,5,0,0,0,0,0,0,0,0,0,0,1
1,1,1,1,4,1,1,1,1,0,0,0,0,0,0,0,0,0,0,1
1,0,0,0,4,0,0,0,0,0,0,0,0,0,0,0,0,8,2,1
1,0,0,0,4,0,0,1,4,0,0,1,1,1,1,1,1,4,1,1
1,0,0,0,4,0,0,1,4,0,0,0,0,0,0,0,0,4,0,1
1,2,0,0,4,0,0,1,4,3,0,0,0,0,0,9,0,4,0,1
1,1,4,1,1,0,0,1,1,1,1,1,1,4,1,1,1,1,1,1
1,0,4,0,0,0,0,0,0,0,0,0,0,4,0,0,0,0,0,1
1,0,4,0,0,0,0,0,0,0,0,0,0,4,0,0,0,0,0,1
1,1,1,1,1,1,4,1,1,1,1,1,1,4,0,0,0,0,0,1
1,0,0,0,0,0,4,0,0,0,0,0,0,4,0,0,0,0,0,1
1,0,0,0,0,0,4,0,0,0,0,0,0,4,0,0,0,0,0,1
1,0,0,4,1,1,1,0,0,0,0,0,0,1,1,1,1,1,4,1
1,6,0,4,0,2,0,0,0,0,3,0,0,0,7,0,0,0,4,1
1,1,1,1,1,1,1,1,1,1,1,1,1,1,1,1,1,1,1,1